#.##.##.##
#######.##
#.#.#..#..
####.##.##
#.##.##.##
#.#####.##
..#.#.....
##########
#.######.#
#.#####.##