#.#L.L#.##
#LLL#LL.L#
L.L.L..#..
#LLL.##.L#
#.LL.LL.LL
#.LL#L#.##
..L.L.....
#L#LLLL#L#
#.LLLLLL.L
#.#L#L#.##