#.#L.L#.##
#LLL#LL.L#
L.#.L..#..
#L##.##.L#
#.#L.LL.LL
#.#L#L#.##
..L.L.....
#L#L##L#L#
#.LLLLLL.L
#.#L#L#.##