#.##.L#.##
#L###LL.L#
L.#.#..#..
#L##.##.L#
#.##.LL.LL
#.###L#.##
..#.#.....
#L######L#
#.LL###L.L
#.#L###.##