#.LL.L#.##
#LLLLLL.L#
L.L.L..L..
#LLL.LL.L#
#.LL.LL.LL
#.LLLL#.##
..L.L.....
#LLLLLLLL#
#.LLLLLL.L
#.#LLLL.##